|--------|
|$*******|
|***|*@**|
|********|
|--------|

 