|--------|
|***|**-*|
|**-|*@**|
|******-*|
|--------|