|--------|
|$*******|
|***|****|
|*******@|
|--------|