|--------|
|$*******|
|*****@**|
|********|
|--------|